___T__T___
__TT__TTTT
_________T
TTTT__T__T
_____X____
_X______X_
